###############################
# #         # #     #   #     #
# ### # # # # # ####### ##### #
#     # # #   #   #           #
### ######### ### ##### # #####
#           #     #     # #   #
# ### ### ##### ### ##### # ###
#   # # # # #         #   #   #
# ##### # # ######### ### ### #
#       # #   #   #     #     #
# # # ##### # ### # ### ##### #
# # #       #     # #     #   #
##### ##### ##### ### # # ### #
#       #   # #     # # #   # #
######### ### ### # ##### ### #
#     #     #     # #   #   # #
# ##### ### # ##### ### ### ###
# #     #   # # #     #       #
# # # ######### # # ### ### # #
#   # # #     # # # # # #   # #
# ##### ### ### ### # # #######
# # #         # #     #   #   #
# # ### # # # # # ####### ### #
#   #   # # #       #         #
### ##### ### # ####### ##### #
#   #   #   # # #   #   # #   #
# ### ##### # ### # ##### # # #
#     #     # #   #   #     # #
### # ### # ####### # # # # ###
#   # #   #     #   #   # #  E#
###############################
